^^^```````````````````````````^
^^````**````````````````~~~```^
^^```**```````````````~~~`````^
^`````````````````````````````^
````~~~```````````````````````^
````~~~```````````````````````^
```~~~~```````````````^^``````^
`````~~~`````````````^^^^`````^
`````~~~~``````````````^^^^```^
```````~``````````````````````^
``````````````````````````````^
``````````````````````````````^