^^^```````````````````````````^
^^`+``**````````````````~~~```^
^^```**```````````````~~~`````^
^`````````````````````````````^
````~~~```````````````````````^
````~~~```````````````````````^
```~~~~```````````````^^``````^
`````~~~`````````````^^^^`````^
`````~~~~``````````````^^^^```^
```````~``````````````````````^
``````````````````````````+```^
``````````````````````````````^