^^^```````````````````````````^
^^`+```*````````````````~~~```^
^^```*````````````````~~~`````^
^`````````````````````````````^
````~~~```````````````*```````^
````~~~```````````````````````^
+++~~~~```````````````^^``````^
````*~~~`````````````^^^^`````^
`````~~~~``````````````^^^^```^
```````~``````````````````````^
```````````*``````````````+```^
``````````````````````````````^